NO textures/wall_N.xpm
SO textures/wall_S.xpm
WE textures/wall_W.xpm
EA textures/wall_E.xpm

C 107, 209, 237
F 102, 217, 85

001111111
0W000011
100000001
100000001
100000001
100000001
100000001
111111111
