NO ./textures/wall_N.xpm
SO ./textures/wall_S.xpm
WE ./textures/wall_W.xpm
EA ./textures/wall_E.xpm

F 220,100,0
C 225,30,0

111111111111111111111111111
111000000000000000000011111
11100000000000000000111111
110000000000001111111111111
100000000000000000000000011
111111100000000000000000111
110000000000000000000001111
110000000000000000000001111
1100000000W0000000000001111
1100000000000000000000001111
11000000000000000000001111
110000000000000000000000111
1111111111111111111111111
