NO ./resources/textures/Bricks007_2K-JPG_Color.xpm
SO ./resources/textures/Plaster001_2K-JPG_Color.xpm
WE ./resources/textures/Tiles045_2K-JPG_Color.xpm
EA ./resources/textures/Wood003_2K-JPG_Color.xpm

F 220,100,0
C 225,30,0

111111111111111111111111111
111000000000000000000011111
111000000000000000000111111
110000000000001111111111111
100000000000000000000000011
11111110000000000000000W111
110000000000000000000001111
110000000000000000000001111
110000000000000000000001111
110000000000000000000001111
110000000000000000000001111
110000000000000000000001111
111111111111111111111111111
