NO textures/wall_N.xpm
SO textures/wall_S.xpm
WE textures/wall_W.xpm
EA textures/wall_E.xpm

F 98,105,109
C 80,130,200

11111
10001
1S0011
10001
111111
