NO textures/wall_N.xpm
SO textures/wall_S.xpm
WE textures/wall_W.xpm
EA textures/wall_E.xpm

F 98,105,109
C 80,130,200

111111111111111111
100000000000000001
100000000000000001
100000000000111111
111110000000100001
111110000000111001
100000000000000001
111111111111111111
