NO textures/Brick_08-128x128.xpm
SO textures/Plaster_03-128x128.xpm
WE textures/Stone_05-128x128.xpm
EA textures/Wood_05-128x128.xpm

F 98,105,109
C 80,130,200

111111111111111111111111111
100000000000000000000000001
10000000S000000001111111101
000000000000111111111111001
111110000000100001000000011
111110000000111001111111111
100000000000000001
111111111111111111
