NO ./textures/wall_N.xpm
SO ./textures/wall_S.xpm
WE ./textures/wall_W.xpm
EA ./textures/wall_E.xpm

F 220,100,0
C 225,30,0

1111111111111111111111111
1000000000110000000000001
1011000001110000000000001
1001000000000000000000001111111111
11111111101100000111000000000000111101
1000000000110000011101111111111111111
11110111111111011100000010001
111101111111 1011101010010001
1100000011011011100000010001
10000000000000001100000010001111111
100000000000000011010N10010000000001
11000001110101011111011110000111111
11110111 1110101 101111010001
11111111 1111111 111111111111